1 1 1 1 1 1 1 1 1 1 1 1 1 1 1 1 1 1 1 1
2 0 0 0 0 0 0 0 0 0 0 0 0 0 0 0 0 0 0 2
2 0 0 0 0 0 0 0 0 0 0 0 0 0 0 0 0 0 0 2
2 0 0 0 0 0 0 0 0 0 0 0 0 0 0 0 0 4 0 2
2 0 0 0 0 0 0 1 1 1 1 0 0 0 0 1 1 1 1 2
2 0 0 0 0 0 0 2 2 2 2 0 0 0 0 2 2 2 2 2
2 0 0 0 0 0 0 0 0 0 0 0 0 0 0 0 0 0 0 2
2 1 1 0 0 0 0 0 0 0 0 0 0 0 0 0 0 0 0 2
2 2 2 0 0 0 0 0 0 0 0 0 0 0 0 0 0 0 0 2
2 2 2 0 0 0 0 17 1 1 18 0 0 0 0 0 0 0 0 2
2 2 0 0 0 0 0 17 2 2 18 0 0 0 0 0 0 0 0 2
0 0 0 0 0 0 0 0 0 0 0 0 0 0 0 0 0 0 0 2
0 0 0 0 0 0 0 0 0 0 0 0 0 0 0 0 0 0 0 2
0 0 0 0 0 0 0 0 0 0 0 0 0 0 0 0 0 0 0 2
2 2 0 1 1 0 0 0 0 0 0 0 0 1 1 1 1 1 1 2
2 18 0 17 2 0 0 0 0 0 0 0 0 10 0 0 0 0 0 2
2 18 0 17 2 1 1 1 16 16 0 0 0 10 0 0 0 0 0 2
2 18 0 17 2 2 2 2 1 1 0 0 0 10 0 0 0 0 0 2
2 18 0 17 2 2 2 2 2 2 0 0 0 10 0 0 20 0 0 2
2 2 2 2 2 2 2 2 2 2 1 1 1 1 1 1 1 1 1 2
