1 1 1 1 1 1 1 1 1 1 1 1 1 1 1
2 0 0 0 0 0 0 10 0 0 0 0 0 0 2
2 0 0 0 0 0 0 10 0 0 0 0 0 0 2
2 0 0 0 0 0 0 10 0 0 0 0 0 0 2
2 0 0 0 0 0 0 10 0 0 0 0 0 0 2
2 0 0 0 0 0 0 10 0 0 0 0 0 0 2
2 0 0 0 4 0 0 10 0 0 20 0 0 0 2
2 2 2 2 2 2 2 2 2 2 2 2 2 2 2
2 2 2 2 2 2 2 2 2 2 2 2 2 2 2
2 2 2 2 2 2 2 2 2 2 2 2 2 2 2
2 2 2 2 2 2 2 2 2 2 2 2 2 2 2
2 2 2 2 2 2 2 2 2 2 2 2 2 2 2
2 2 2 2 2 2 2 2 2 2 2 2 2 2 2
2 2 2 2 2 2 2 2 2 2 2 2 2 2 2
2 2 2 2 2 2 2 2 2 2 2 2 2 2 2
